ahead - предстоит
Although - хотя
about - о, около
assemble - собирать, монтировать, составлять
act - акт, действие, закон, представление
appear - появляться, проявляться, казаться
afternoon - полдень
alert - тревога, сигнал, внимание
as much as - столько же, сколько; поскольку

bring - приносить, приводить
believe - полагают
blood pressure - артериальное давление
benefit - преимущество, выгода
benefit of napping - преимущества дневного сна
be able to - быть способным
bit - бит, кусочек, частица, долото
brighten - ярче

compared - в сравнении
case - случай, кейс, дело
called - называемые (сообщения называемые телеграммами)
candle - свеча
catcher - ловец
capture - захватить, поймать
common - общий, обыкновенный
commonly - обычно, обыкновенно
commonly known as - широко известный как
carrier - перевозчик
courier - курьер
сourt - суд
сourt jester - придворный шут
cozy up to - уютно устраиваться

due to - из-за
disease - болезнь
during - в течении
dispatch rider - мотоциклист связи
dispatch - отправлять, посылать, казнить, предание смерти
disapper - пропадать, исчезнуть

ease - простота, легкость
exist - существовать
each - каждый
eradicate - искоренить
entertainer - артист
eyelid - веко
even - даже

going through - переживает, переживать
get - попадать, иметь, становиться
gone - ушел
generally - в целом, обычно, вообще
grogginess - сонливость

had to ask - приходилось просить
have been - был
households - домохозяйство
humorous - юмористический

infested - заражены (infested with rats - заражены крысами)
intereception - перехват
involve - вовлекать, включать в себя
improve - улучшать
important - важный

find out - выяснить, узнать, познать
found - найденный, основываться
feel down - чувствовать себя подавленным
fall - падать

jester - шут, шутник

kind - добрый, вид, тип, разновидность
a kind of - типа
keep - хранить, держать

lazy - ленивый
layout - макет, схему, оформление
letter - буква, письмо
learn - учиться, научиться

moderate exercise - умеренные физические упражнения
mood - настроение
most - большинство
mostly - в основном, по большей части
motorcyclist - мотоциклист
mid-afternoon - в середине дня

no longer -  больше никогда, больше не
necessary - необходимый
nap - вздремнуть, дремать, дремота, короткий сон
napping - дремлющий

obsolete - устаревший
of - из, (о, от, об, для)
outlook - мировозрение
off taking a nap - пошел вздремнуть
older adults - пожилые люди

pole - шест, столб, кол
put - ставить, класть
poison - яд
prone - склонный
pressing - нажатие, прессование, неотложной, сжатой
perform - выполнять (работу), выступать, исполнять (песню)
public crowd - толпа людей
pressure-filled situations - напряженная ситуация

release - выпускать
rat catcher - крысолов
responsible - ответственный
reliable - надежный
royal - королевский
Renaissance - Ренессанс, эпоха Возрождения

still - все еще, до сих пор
stick - палка
sure - обязательно
study - исследования
studies - исследования
store - хранить, магазин
sense perception - чувственное восприятие
struggle - борьба
spirit - дух
seem - казаться
sipping coffee - пьет кофе
stretching - растяжка

through - через, посредством, благодаря
trick - обманывать, трюк, уловка
ticker - сердце
these - эти
there - там
There is - есть
there used to be - раньше было(был)
telegraph operators - телеграфист
these were like - это были такие
there were many - было много
There’s no need to feel lazy - Не нужно лениться
though - хотя, однако
typesetters - наборщик текста
taking a nap - дремать
transition - переходить

until - до
used to do - раньше делали. Used to означает, что раньше что-то делали, но в данный момент нет.
urgent - срочный

whole - весь, целый
were common - были обычным явлением
wooden - деревянный
wear - носить
works to keep - помогает
worse  - худший, хуже, сильнее


